1111111111111111
1000000000022001
1000333300000001
1000000300000221
1000000300000001
1000333300000221
1000000000000001
1000022222000001
1111111111111111