1111111111111111
1000000000011001
1000111100000001
1000000100000111
1000000100000001
1000111100000111
1000000000000001
1000011111000001
1111111111111111