11111111111111111111111111111111
10002222200000000000000220000001
10000020000003333300000220000001
10000020000003000300002200000001
10000220000033000000000000000001
10000000000033330003333300030001
12222000000000033000000000030001
12222222200000033000000000030001
12222200000000033000222200000001
12200000000003330002222222222221
12200000000003000000000000000001
10000003330000000000000000022001
10000000033333000033330000222221
12222000000000300000000000000001
10022200000200300200000000220221
10000220000200000200000000200001
12200000000200022200000000200221
11111111111111111111111111111111