11111111111111111111111111111111
10000000000000003000000000000001
10333333333333003333333330000201
10020000000030000000000300000201
12220222222222200002222222200201
12000000000000000002002220002001
12033333333333033302200000002021
12000000000003030302000000033331
13333333333333000000020000000021
12000000000000002222222222222221
12002222222222002000200020000021
12002200000000200020002000200021
12020000222222222202220222002221
12000000000000000000222000222221
13333333333333330000003033333331
13000300030003000000000003330001
10030003000300033333333000000331
11111111111111111111111111111111